10 22 15 15 15 15 15 15 15 15 15 15 15 15 15 15 12 12 12 12
23 24 15 15 15 15 15 15 15 15 15 15 15 15 15 15 15 15 15 15
15 15 15 15 15 15 15 15 15 15 15 15 15 15 15 15 15 15 15 15
15 15 15 15 15 15 15 15 15 15 15 15 15 15 15 27 28 29 19 11
15 15 15 15 15 15 15 15 15 15 15 15 15 15 15 21 17 17 16 11
15 15 15 15 15 15 15 15 15 15 15 15 15 15 15 15 15 15 15 15
15 15 15 15 15 15 15 15 15 15 15 15 15 15 15 15 15 15 15 15
12 12 12 12 12 12 12 12 15 15 15 15 15 12 12 12 12 12 12 12
12 12 12 12 12 12 12 12 15 15 15 15 15 12 12 12 12 12 12 12
12 12 12 12 12 12 12 12 15 15 15 15 15 12 12 12 12 12 12 12
15 15 15 15 15 15 15 15 15 15 15 15 15 15 15 15 15 15 15 15
15 15 15 15 15 15 15 15 15 15 15 15 15 15 15 15 15 15 15 15
15 15 15 15 15 15 15 15 15 15 15 15 15 15 15 15 15 15 15 15
15 15 15 15 15 15 15 15 15 15 15 15 15 15 15 15 15 15 15 15
15 15 15 15 15 15 15 15 15 15 15 15 15 15 15 15 15 15 15 15
15 15 15 15 15 15 15 13 13 13 15 15 15 15 15 15 15 15 15 15
