0 0 0 0 1 1 1 1 1 1 0 0 0 0 0 0 0 0 0 0
0 0 0 0 1 1 1 1 1 1 0 0 0 0 0 0 0 0 0 0
0 0 2 2 3 4 5 5 4 3 0 0 1 1 1 1 0 0 0 0
0 0 2 6 5 5 7 5 5 5 0 0 1 1 1 1 0 0 0 0
0 0 2 2 8 8 8 8 8 8 2 2 5 5 3 4 0 0 0 0
0 0 2 2 8 8 8 8 8 8 2 6 5 7 5 5 0 0 0 0
0 0 8 8 8 8 8 8 8 8 8 8 8 8 8 8 8 8 9 9
0 0 8 8 8 8 8 8 8 8 8 8 8 8 8 8 8 8 9 9
8 8 8 8 8 8 8 8 8 6 8 8 8 8 8 8 8 8 9 9
8 8 8 8 8 8 8 8 8 8 8 8 8 8 8 8 8 8 9 9
2 2 8 8 8 8 8 8 8 8 8 8 8 8 8 8 8 8 9 9
0 0 1 1 1 1 8 8 8 8 8 8 8 8 8 8 2 0 0 0
0 0 5 5 7 5 8 8 8 8 8 8 8 8 8 8 2 0 0 0
0 0 8 8 8 8 8 8 2 2 1 1 1 1 8 8 2 0 0 0
0 0 2 2 2 2 8 8 2 6 5 7 5 5 8 8 2 0 0 0
0 0 8 8 8 8 8 8 8 8 8 8 8 8 8 8 8 8 9 9
0 0 0 0 0 0 8 8 8 8 8 8 8 8 8 8 8 8 9 9
0 0 0 0 0 0 0 0 0 0 0 0 0 0 0 0 0 0 0 0
0 0 0 0 0 0 0 0 0 0 0 0 0 0 0 0 0 0 0 0